愛 = とても大切(たいせつ)に思う気持(きも)ちです。
案 = 計画(けいかく)やアイデアのことです。
以 = ある基準(きじゅん)から、前(まえ)や後(うし)ろなどの範囲(はんい)を表す言葉です。
衣 = 服(ふく)のことです。
位 = 順番(じゅんばん)や、物(もの)の場所(ばしょ)のことです。
茨 = とげのある植物(しょくぶつ)やとげのある枝(えだ)のことです。
印 = しるしやマークのことです。
英 = 「えらい人やすぐれたもの、イギリスを表します。
栄 = ほめられてうれしい気持ち、またはさかえることです。
媛 = 愛媛県(えひめけん)の「ひめ」、地名や人名に使われる字です。
塩 = 料理(りょうり)にしょっぱい味(あじ)を付(つ)ける調味料(ちょうみりょう)です。
岡 = ちょっとした山(やま)のことです。
億 = とても大きな数字(すうじ)です。
加 = 足(た)したり、加(くわ)えたりすることです。
果 = フルーツのこと、または結果(けっか)のことです。
貨 = お金(かね)や品物(しなもの)のことです。
課 = 勉強(べんきょう)や仕事(しごと)の区切(くぎ)りのことです。
芽 = 植物(しょくぶつ)の、ちいさな葉(は)っぱのことです。
賀 = お祝(いわ)いの言葉(ことば)です。
改 = 変(か)えたり、直(なお)したりすることです。
械 = 機械(きかい)のことです。
害 = 人(ひと)や物(もの)に悪(わる)い影響(えいきょう)をあたえることです。
街 = 家(いえ)がたくさん並(なら)んでいる場所(ばしょ)です。
各 = それぞれ、みんなのことです。
覚 = 気(き)づいたり、感(かん)じたりすることです。
潟 = 海(うみ)や湖(みずうみ)の近くにある、どろの多い場所(ばしょ)です。
完 = 全部終わったり、そろったりすることです。
官 = 役所(やくしょ)で働(はたら)く人(ひと)のことです。
管 = くだのようなのもの、または管理(かんり)することです。
関 = ２つのものがつながること、または関係(かんけい)があることです。
観 = 見(み)ること、または考(かんが)え方(かた)のことです。
願 = お願(ねが)いすることです。
岐 = 道(みち)が分(わ)かれるところです。
希 = めったにないことです。
季 = 四季(しき)のことです。春夏秋冬(しゅんかしゅうとう)。
旗 = 布(ぬの)などを竿(さお)などに張(は)り、よく見(み)えるようにかかげるものです。
器 = 入(い)れ物(もの)のこと、または道具(どうぐ)のことです。
機 = 機械(きかい)のこと、またはチャンスのことです。
議 = みんなで話(はな)し合(あ)うことです。
求 = ほしがること、さがすことです。
泣 = なみだを流(なが)すことです。
給 = 与(あた)えること、または与(あた)えられることです。
挙 = 手(て)や例(れい)を挙(あ)げることです。
漁 = 魚(さかな)をとることです。
共 = 一緒(いっしょ)に、みんなでということです。
協 = みんなで力(ちから)を合(あ)わせることです。
鏡 = 自分(じぶん)の顔(かお)などをうつす道具(どうぐ)です。
競 = 競争(きょうそう)することです。
極 = 一番(いちばん)端(はし)っこのこと、きわめることです。
熊 = 動物(どうぶつ)のクマのことです。
訓 = 教えたり、読み方を教えたりすることです。
軍 = 兵士(へいし)の集(あつ)まりのことです。
郡 = 町(まち)や村(むら)をまとめた場所(ばしょ)の名前(なまえ)です。
群 = たくさんの人(ひと)や動物(どうぶつ)の集(あつ)まりです。
径 = 円(えん)のまんなかを通(とお)る長(なが)さのことです。
景 = 景色(けしき)や様子(ようす)のことです。
芸 = 芸能(げいのう)のこと、または技術(ぎじゅつ)のことです。
欠 = 足(た)りないこと、不足(ふそく)していることです。
結 = むすんだり、結果(けっか)を出(だ)したりすることです。
建 = 家(いえ)やビルをつくることです。
健 = 体(からだ)が元気(げんき)で、健康(けんこう)なことです。
験 = 経験(けいけん)や実験(じっけん)のことです。
固 = かたいこと、かためることです。
功 = 努力(どりょく)して、いい結果(けっか)を出(だ)すことです。
好 = 好(す)きな気持(きも)ちのことです。
香 = いい匂(にお)いのことです。
候 = 季節(きせつ)のこと、または様子(ようす)をうかがうことです。
康 = 体(からだ)が元気(げんき)で、健康(けんこう)なことです。
佐 = 地名(ちめい)や人名(じんめい)によく使われる漢字です。
差 = ２つのもののちがいのことです。
菜 = 野菜(やさい)のことです。
最 = 一番(いちばん)何(なに)かであることです。
埼 = 地名(ちめい)によく使われる漢字です。
材 = 材料(ざいりょう)や木材(もくざい)などのことです。
崎 = 地名(ちめい)によく使われる漢字です。
昨 = 一(ひと)つ前(まえ)のことです。
札 = 紙(かみ)のお金(かね)や、お札(ふだ)などのことです。
刷 = 紙(かみ)に文字(もじ)や絵(え)をうつすことです。
察 = よく調(しら)べることです。
参 = 何(なに)かに参加(さんか)することです。
産 = 生(う)むこと、または作(つく)ることです。
散 = ばらばらにすることです。
残 = とどまっていることです。
氏 = 名字(みょうじ)や名前(なまえ)のことです。
司 = つかさどること、リーダーのことです。
試 = ためすこと、テストのことです。
児 = 子(こ)どものことです。
治 = 悪(わる)いところを治(なお)したり、国をおさめたりすることです。
滋 = 栄養(えいよう)がたくさんあることです。
辞 = 言葉(ことば)のこと、またはやめることです。
鹿 = 動物(どうぶつ)のシカのことです。
失 = あったものをなくすことです。
借 = 人(ひと)からお金(かね)や物(もの)を借(か)りることです。
種 = 植物(しょくぶつ)の種(たね)や、種類(しゅるい)のことです。
周 = 周(まわ)りのこと、またはまわることです。
祝 = お祝(いわ)いすることです。
順 = 順番(じゅんばん)のことです。
初 = 一番(いちばん)始(はじ)めのことです。
松 = まつの木(き)のことです。
笑 = にこにこすることです。
唱 = 歌(うた)ったり、大きな声(こえ)で言(い)ったりすることです。
焼 = 燃(も)やしたり、焼(や)いたりすることです。
照 = 明(あか)るく光(ひかり)を当(あ)てたり、見比(みくら)べることです。
城 = お城(しろ)のことです。
縄 = 糸(いと)より丈夫(じょうぶ)で太(ふと)いロープのことです。
臣 = 家来(けらい)のことです。
信 = うたがわずに本当(ほんとう)だと思(おも)い込(こ)むことです
井 = 地面(じめん)に穴(あな)をほって水(みず)をくみ上(あ)げる場所(ばしょ)です。
成 = できあがることです。
省 = はぶくこと、または反省(はんせい)することです。
清 = 汚(よご)れていないこと、きれいなことです。
静 = うるさい音(おと)がないことです。
席 = すわる場所(ばしょ)のことです。
積 = ものを上(うえ)に重(かさ)ねることです。
折 = 平面状(へいめんじょう)、糸状(いとじょう)のものをするどく曲(ま)げることです。
節 = 区切(くぎ)りのことです。
説 = 説明(せつめい)することや、考(かんが)えです。
浅 = 深(ふか)くないことです。
戦 = 何(なに)かの目的(もくてき)で集団(しゅうだん)で争(あらそ)うことです。
選 = どれにするか決(き)めることです。
然 = そのとおりであること、または「～のように」という意味で使われます。
争 = けんかしたり、競い合ったりすることです。
倉 = 何(なに)か物(もの)を置(お)いておく倉庫(そうこ)のことです。
巣 = 鳥(とり)のすみか、ハチのすみかのことです。
束 = たばねること、たばねたもののことです。
側 = 横(よこ)の方(ほう)のことです。
続 = 連続(れんぞく)することです。
卒 = 学校(がっこう)での勉強(べんきょう)をすべて終(お)わらせることです。
孫 = 子(こ)どもの子(こ)どものことです。
帯 = 帯(おび)やベルトのことです。
隊 = グループやチームのことです。
達 = やりとげること、または何人(なんにん)かの人々(ひとびと)のことです。
単 = ひとつのことです。
置 = 物(もの)を置(お)くことです。
仲 = 友達(ともだち)や仲間(なかま)、人間関係(にんげんかんけい)のことです。
沖 = 海の岸から遠い場所です。
兆 = とても大(おお)きな数(かず)のこと、または前(まえ)ぶれのことです。
低 = 下(した)の位置(いち)にあること、数(かず)が小さいことです。
底 = 一番下(いちばんした)の部分(ぶぶん)のことです。
的 = 的(まと)のこと、または目標(もくひょう)のことです。
典 = 手本(てほん)となることです。
伝 = 言葉(ことば)や情報(じょうほう)を知らせたり残すことです。
徒 = 弟子(でし)のことです。
努 = 何かのことにうちこんで、努力(どりょく)することです。
灯 = 明(あ)かりのことです。
働 = 仕事(しごと)をすることです。
特 = 特別(とくべつ)なことです。
徳 = 人としてよい行(おこな)いのこと、または道徳(どうとく)のことです。
栃 = 栃木県(とちぎけん)の「とち」、木の一種です。
奈 = 地名(ちめい)や人名(じんめい)によく使(つか)われる漢字です。
梨 = 甘(あま)いフルーツ、梨(なし)のことです。
熱 = 温度(おんど)が高(たか)いこと、高(たか)くするものです。
念 = 気持(きも)ちや考(かんが)えのことです。
敗 = 勝負事(しょうぶごと)に負(ま)けることです。
梅 = うめの木(き)のことです。
博 = 知識(ちしき)が広(ひろ)いこと、または博士(はかせ)のことです。
阪 = 大阪府(おおさかふ)の「さか」、坂道(さかみち)のことです。
飯 = ご飯(はん)のことです。
飛 = 空中(くうちゅう)をとぶことです。
必 = かならず、という意味です。
票 = 投票(とうひょう)のことです。
標 = しるし、目標(もくひょう)のことです。
不 = 否定(ひてい)することです。～ではない、という意味です。
夫 = 結婚(けっこん)した夫婦(ふうふ)の男(おとこ)の方(ほう)です。
付 = ２つのものが触(ふ)れたまま、はなれないようにすることです。
府 = 政府(せいふ)の体制(たいせい)、大阪(おおさか)や京都(きょうと)のことです。
阜 = 岐阜県(ぎふけん)の「ふ」、地名(ちめい)によく使われます。
富 = お金持(かねも)ちのこと、または豊(ゆた)かにすることです。
副 = 主(おも)なものを助(たす)ける役目(やくめ)のことです。
兵 = 軍隊(ぐんたい)のメンバーのことです。
別 = 分(わ)けること、他(ほか)のことです。
辺 = そこに近(ちか)い場所(ばしょ)です。
変 = ちがうものになることです。
便 = たよりや手紙(てがみ)、べんりなこと。トイレの意味(いみ)でも使います。
包 = ものを大(おお)きなものでくるんだり、中(なか)に入(い)れることです。
法 = 決(き)まりごとのことです。
望 = 望(のぞ)むこと、希望(きぼう)のことです。
牧 = 家畜(かちく)を飼(か)うこと、牧場(ぼくじょう)のことです。
末 = 終(お)わりのときのことです。
満 = いっぱいのこと、満足(まんぞく)させることです。
未 = まだ、～ではないことです。
民 = 国(くに)や地域(ちいき)にぞくする人々(ひとびと)のことです。
無 = 存在(そんざい)しないこと、ないことです。
約 = お約束(やくそく)、またはおおよそのことです。
勇 = 心(こころ)が強(つよ)く、勇気(ゆうき)があることです。
要 = 必要(ひつよう)なことです。
養 = 育(そだ)てることです。
浴 = お風呂(ふろ)に入(はい)ることです。
利 = 役(やく)に立(た)つこと、またはするどいことです。
陸 = 水(みず)におおわれていない地面(じめん)のことです。
良 = よいこと、すぐれていることです。
料 = 材料(ざいりょう)や料金(りょうきん)のことです。
量 = はかるとわかる重(おも)さや体積(たいせき)、容積(ようせき)などのことです。
輪 = 輪(わ)ゴムや、車輪(しゃりん)などのわっかのことです。
類 = 同(おな)じタイプのもののことです。
令 = きまりや命令(めいれい)のこと、令和(れいわ)の令(れい)です。
冷 = 温度(おんど)が低(ひく)く、冷(ひ)えていることです。
例 = たとえばのことです。
連 = つながって続(つづ)くことです。
老 = 年(とし)をとることです。
労 = 働(はたら)くこと、体(からだ)を使(つか)うことです。
録 = データとして残(のこ)しておくことです。
