愛 = Loving
案 = Proposal; Plan; Draft
以 = (―er Than Or Equal)
衣 = Clothing; Dressing
位 = Rank; Grade; Throne
茨 = Thorns
印 = Mark; Symbol; Stamp; (India)
英 = English; Excellent; Outstanding
栄 = Thrive
媛 = Hime of Ehime (愛媛) Pref.; (Princess)
塩 = Salt
岡 = Hill
億 = Hundred Million; 100000000
加 = Addition; (Canada)
果 = Fruit; Fulfill
貨 = Currency; Cargo; Freight
課 = Division; Impose
芽 = Bud; Sprout
賀 = -
改 = Revised; Renew
械 = (Machine)
害 = Harm
街 = Street; Town
各 = Each
覚 = Awakening
潟 = Lagoon
完 = Complete
官 = Government
管 = Tube; Pipe; (Managing)
関 = Barrier; Gate; Concern
観 = View; Sightseeing; Observe
願 = Wish
岐 = (Branch)
希 = Rare; Hope
季 = (Season)
旗 = Flag
器 = Vessel; Bowl; Container
機 = (Machine); (Loom)
議 = (Discussion)
求 = Request
泣 = Cry
給 = Supply; Salary; Wage
挙 = (Give an example); (Raise); (Behavior)
漁 = Fishing
共 = (Jointly)
協 = Cooperate
鏡 = Mirror
競 = Competition
極 = Very; Quite
熊 = Bear (animal)
訓 = Japanese reading (of kanji); Instruction
軍 = Army; Troops
郡 = County; District
群 = Group; Flock
径 = Diameter
景 = Scenery
芸 = Art
欠 = Missing
結 = Conclusion; Tying; Binding
建 = Building; Construction
健 = (Healthy)
験 = Experience; Try; Test
固 = Hard; Solid; (Fixed)
功 = Merit; Achievement
好 = Liking; Favorite
香 = Scent; Incense
候 = Weather; Season; Time; (Candidate)
康 = Health
佐 = (Kanji commonly used in person/place names)
差 = Difference; Variation; (Insert); (Use an umbrella)
菜 = Vegetables; Greens
最 = Most
埼 = (Kanji commonly used in person/place names)
材 = Material
崎 = (Kanji commonly used in person/place names)
昨 = Last
札 = Paper Money; Token
刷 = Printing
察 = (Inspection); (Police)
参 = Visit (a shrine); Come; Defeated
産 = Production; Give birth
散 = Scattered; (Take a walk)
残 = Remaining
氏 = Mr.; Family name
司 = Govern
試 = Trial; Test; Try
児 = (Child); (Kid)
治 = Healing; Govern
滋 = (Nourish)
辞 = Words; Resign; Decline
鹿 = Deer
失 = Loss; Failure
借 = Debt; Borrowing
種 = Seed; Species; Trick
周 = Surroundings
祝 = Congratulations
順 = Order
初 = First time
松 = Pine tree
笑 = Laughing; Smile
唱 = Chanting
焼 = Grill; Burn; Bake
照 = Illuminate; Shine
城 = Castle
縄 = Rope
臣 = (Minister)
信 = Trust; Faith
井 = Well (of water)
成 = Growth; Become
省 = Omit; Ministry
清 = Clean; Pure
静 = Silence; Quiet
席 = Seat
積 = Pile up; Product (of numbers)
折 = Fold
節 = Section; Node; Joint
説 = Theory; Explain
浅 = Shallow
戦 = War; Battle; Fight
選 = Selection; Election; Choose
然 = Naturally
争 = Compete; Dispute
倉 = Storehouse; Warehouse
巣 = Nest; Beehive
束 = Bundle; Bunch
側 = Side; -side
続 = Continue
卒 = Graduate; Die; Finish
孫 = Grandchild
帯 = Belt; Band; Obi
隊 = Squad
達 = Reach; Arrive; (Multiple people)
単 = (Single)
置 = Put; Place
仲 = Relationship
沖 = Oki
兆 = Trillion; (Signs)
低 = Low
底 = Bottom
的 = Target; (-like)
典 = (Ceremony); (Law); (Typical)
伝 = Tell; Transmission; Biography; Legend
徒 = (Student); (Party)
努 = Strive; Exert
灯 = Light (of fire)
働 = Work; Labor
特 = Special
徳 = Virtue
栃 = Tochi of Tochigi (栃木) Pref.
奈 = (Kanji commonly used in place names)
梨 = Pear
熱 = Heat; Fever
念 = Thought
敗 = Defeat
梅 = Plum
博 = Expo; Museum; (Doctorate); (Gamble)
阪 = Saka of Osaka (大阪) Pref.; (Slope)
飯 = Rice; Meals
飛 = Fly
必 = Must
票 = Vote
標 = Mark; Sign; Elevation; Standard
不 = Not doing
夫 = Husband
付 = Attach; Wear; With
府 = (Prefecture)
阜 = Fu of Gifu (岐阜) Pref.
富 = Wealth
副 = Deputy; Assistant; Auxiliaty
兵 = Soldier; Warrior
別 = Another; Different; Separate
辺 = Area; Edge (of math)
変 = Change; Strange; Funny
便 = Convenience; Flight; Mail; Excrement
包 = Wrap; Pack; (Package)
法 = Law
望 = Desire; Hope
牧 = (Ranch); (Pasture)
末 = End; Last
満 = Full; Satisfy; Fulfill
未 = Not yet
民 = Nation; Private
無 = Nothing
約 = Approximately; Promise
勇 = Courage; Bravery
要 = Need; Main point
養 = Raise; Nourish
浴 = Bath; Bathe
利 = Advantage; Interest; Profit; Benefit
陸 = Land
良 = Good; Excellent
料 = Fee; (Cooking)
量 = Amount; Quantity; Volume
輪 = Ring; Loop; Hoop; (Wheel)
類 = Kind (of something)
令 = (Command); (Order)
冷 = Cold; Cool
例 = Example
連 = Consecutive; (Connect); (Link)
老 = Old person
労 = Labor
録 = Record
