一 = One; 1
右 = Right
雨 = Rain
円 = Circle; Yen
王 = King
音 = Sound; Audio
下 = Below; Down; Lower
火 = Fire; Tue
花 = Flower
貝 = Shell
学 = Learning; Academy
気 = Mind; Mental; Mental Power
九 = Nine; 9
休 = Rest
玉 = Ball; Bullet
金 = Money; Gold; Metal; Fri
空 = Sky; Empty; (Opened)
月 = Moon; Month; Mon
犬 = Dog
見 = Look; See
五 = Five; 5
口 = Mouth
校 = (School)
左 = Left
三 = Three; 3
山 = Mountain; Pile
子 = Child
四 = Four; 4
糸 = String; Thread
字 = Character (not personal); Letter (not mail)
耳 = Ear
七 = Seven; 7
車 = Car; Vehicle
手 = Hand; Arm
十 = Ten; 10
出 = Go Out
女 = Woman; Female
小 = Small; Little
上 = Above; Up; Raise
森 = Forest
人 = Person; People
水 = Water; Wed
正 = Correct
生 = Living; Life
青 = Blue; (Green)
夕 = Evening
石 = Stone
赤 = Red
千 = Thousand; 1000
川 = River
先 = Before; Previous; Ahead
早 = Early
草 = Grass
足 = Leg; Foot
村 = Village
大 = Big; Large
男 = Man; Male
竹 = Bamboo
中 = In; Inside; Ing; (China)
虫 = Insect; Bug; Worm
町 = Town
天 = Heaven; Sky
田 = Rice Field
土 = Soil; Earth; Sat
二 = Two; 2
日 = Day; Sun; (Japan)
入 = Enter
年 = Year; Age
白 = White; (Innocent)
八 = Eight; 8
百 = Hundred; 100
文 = Sentence; Letter; Writing
木 = Wood; Thu
本 = Book; Main; Real; Origin
名 = Name
目 = Eye
立 = Stand
力 = Power; Force
林 = Woods
六 = Six; 6
