引 = Pull
羽 = Feather; Wing; Plume
雲 = Cloud
園 = Garden; Park; Plantation
遠 = Far; Distant
何 = What
科 = Department; Section; (Science)
夏 = Summer
家 = House; Home; Residence
歌 = Song; Sing
画 = Picture; Stroke
回 = Rotate; Rolling; Times
会 = Meeting; Association; Party; Club; Assembly
海 = Sea
絵 = Picture; Painting; Drawing; Illustration; Sketch
外 = Outside; Foreign
角 = Corner; Angle; Horn
楽 = Easy; Comfort; Music; Fun
活 = Living; Life; Active
間 = Interval; Space; Pause; Room
丸 = Circle; Pill
岩 = Rock
顔 = Face
汽 = Steam
記 = Note; Chronicle
帰 = Return
弓 = Bow
牛 = Cattle; Cow
魚 = Fish
京 = Capital; (Kyoto); 10,000,000,000,000,000
強 = Strong; Intense
教 = Teaching
近 = Near
兄 = Older Brother
形 = Shape; Form; Type
計 = Total; Calculate
元 = Former; Origin; Yuan
言 = Say; Words
原 = Original; Primitive; Field
戸 = Door
古 = Old; Used; Ancient
午 = Noon
後 = Rear; Later; Remainder
語 = Word; Language
工 = Engineering
公 = Public; Open; Lord
広 = Wide; Widen; Spread
交 = Exchange; Crossing
光 = Light; Shine
考 = Thoughts; Think
行 = Line; Go; Row
高 = High; Expensive
黄 = Yellow
合 = Match; Fit
谷 = Valley
国 = Country
黒 = Black; Dark
今 = Now; This; Immediately
才 = Talent; Years Old
細 = Thin; Detail
作 = Make; Work; Product
算 = Calculate; Arithmetic
止 = Stop
市 = City; Market; Town; Fair
矢 = Arrow
姉 = Older Sister
思 = Thoughts; Feeling
紙 = Paper
寺 = Temple
自 = Self
時 = Time; Hour; Occasion
室 = Room
社 = Company; Shinto Shrine
弱 = Weak; Feeble
首 = Neck
秋 = Autumn; Fall
週 = Week
春 = Springtime
書 = Write; Calligraphy
少 = Few; Scarce; Little
場 = Place; Field
色 = Color; Variety; (Sexy)
食 = Food; Eat
心 = Heart; Mind; Core
新 = New
親 = Parent; Familiar
図 = Figure; Drawing; Attempt
数 = Number
西 = West
声 = Voice; Opinion
星 = Star
晴 = Sunny
切 = Cut; Eager; Acute; Keen
雪 = Snow
船 = Boat; Ship; Vessel
線 = Line; Wire; Beam
前 = Before (time); Forward (place); Front; Previous; Former
組 = Group; Set; Class
走 = Run
多 = Many
太 = Thick
体 = Body; Form; Substance; Health
台 = Stand; Table; Pedestal; Support
地 = Earth; Ground
池 = Pond
知 = Know; Knowledge
茶 = Tea; Brown
昼 = Noon; Daytime
長 = Long; Chief; Boss
鳥 = Bird; Poultry; Fowl
朝 = Morning; Imperial
直 = Straight; Direct; Fix
通 = Go; Street; Expert; Understand
弟 = Younger Brother
店 = Shop; Store
点 = Point; Dot; Spot; Lighting
電 = Electric
刀 = Sword; Knife; Blade
冬 = Winter
当 = Current; Hit
東 = East
答 = Answer
頭 = Head; (counter for large animals)
同 = Same
道 = Road; Way; Method
読 = Read
内 = Inside
南 = South
肉 = Meat; Flesh
馬 = Horse
売 = Sell
買 = Buy
麦 = Wheat; Barley
半 = Half
番 = Number; Watching; Turn
父 = Father
風 = Wind; Breeze; Blast; Style
分 = Minutes; Divide; Branch; Rate
聞 = Listen; Hear
米 = Rice; (Meter); (America)
歩 = Walk; Step; Stride; Pawn
母 = Mother
方 = Direction; Person; Side
北 = North
毎 = Every; Each
妹 = Younger Sister
万 = Ten Thousand; All
明 = Bright; Luminous; Enlightened
鳴 = Sound; Ring; Echo
毛 = Hair; Fur
門 = Gate
夜 = Night
野 = Field
友 = Friend; Companion; Pal
用 = Use; Business
曜 = Day Of The Week
来 = Next; Come
里 = Village; Home Country; (Mile)
理 = Reason; (Science)
話 = Story; Talk; Speech
