胃 = Stomach
異 = Different; Uncommon; Strange
遺 = Leave Behind; Legacy; Bequeath
域 = Area; Region; Zone; Limit
宇 = Universe; Space; Roof
映 = Projection; Reflect; Shine
延 = Prolong; Extend; Postpone
沿 = Run alongside; Follow
恩 = Grace; Favor; Kindness
我 = I; Self; Ego
灰 = Ash; Dust; Gray
拡 = Expand; Enlarge; Spread
革 = Leather; Reform
閣 = Tower; Cabinet; Pavilion
割 = Divide; Cut; Split; Proportion
株 = Stock; Share; Stump
干 = Dry; Interfere; Shield
巻 = Scroll; Roll; Volume
看 = Watch; Guard; Nurse
簡 = Simple; Brief; Letter
危 = Danger; Risk; Peril
机 = Desk
揮 = Wave; Brandish; Command
貴 = Noble; Precious; Valuable
疑 = Doubt; Suspect; Question
吸 = Suck; Absorb; Inhale
供 = Offer; Provide; Accompany
胸 = Chest; Breast; Heart
郷 = Hometown; Countryside
勤 = Diligence; Work; Service
筋 = Muscle; Sinew; Line
系 = System; Lineage; Connection
敬 = Respect; Honor; Revere
警 = Warn; Guard; Police
劇 = Drama; Theater; Play
激 = Intense; Fierce
穴 = Hole; Cave
券 = Ticket; Certificate; Coupon
絹 = Silk
権 = Authority; Power; Right
憲 = Constitution
源 = Source; Origin
厳 = Strict; Severe; Stern
己 = Self; Oneself
呼 = Call; Breathe; Summon
誤 = Mistake; Error
后 = Empress; Queen
孝 = Filial piety; Respect for Parents
皇 = Emperor; Imperial
紅 = Deep red
降 = Descend; Fall; Surrender
鋼 = Steel
刻 = Engrave; Carve; Time
穀 = Grain; Cereal; Crop
骨 = Bone; Frame
困 = Trouble; Difficulty; Get stuck
砂 = Sand
座 = Seat; Sit; Place
済 = Settle; Relieve; Finish
裁 = Judge; Decide; Tailor; Cut
策 = Plan; Scheme; Policy; Measure
冊 = Book; Counter for books
蚕 = Silkworm
至 = Reach; Attain; Extreme
私 = I; Private; Personal
姿 = Figure; Shape; Appearance
視 = Look; See; Observe
詞 = Word; Phrase; Part of speech; Lyrics
誌 = Magazine; Journal
磁 = Magnet; Magnetic; Porcelain
射 = Shoot; Emit; Radiate
捨 = Throw Away; Abandon; Discard
尺 = Shaku (unit of length); Measure
若 = Young; If; Perhaps
樹 = Tree
収 = Obtain; Collect; Income
宗 = Religion; Sect; Origin
就 = Settle in; Take up
衆 = Public; Crowd; Masses
従 = Follow; Obey; Accompany
縦 = Vertical
縮 = Shrink; Contract; Curtail
熟 = Ripe; Mature; Skilled
純 = Pure; Genuine; Simple
処 = Dispose of; Deal With; Manage
署 = Signature; Government Office
諸 = Various; All kinds
除 = Remove; Exclude; Except
承 = Receive; Inherit; Consent
将 = General; Commander; Leader
傷 = Wound; Injury; Hurt
障 = Hinder; Obstruct; Barrier
蒸 = Steam; Evaporate
針 = Needle; Pin; Staple
仁 = Humanity; Benevolence; Virtue
垂 = Hang; Suspend; Droop
推 = Infer; Recommend; Push
寸 = Sun (unit of length); Small amount
盛 = Prosper; Flourish; Serve
聖 = Holy; Sacred; Saint
誠 = Sincerity; Honesty; Truth
舌 = Tongue
宣 = Declare; Announce; Proclaim
専 = Specialty; Exclusive; Professional
泉 = Spring; Fountain
洗 = Wash; Cleanse
染 = Dye; Stain; Taint
銭 = Coin; Money
善 = Good; Virtue
奏 = Play music; Perform; Report to an emperor
窓 = Window
創 = Create; Originate; Wound
装 = Clothe; Dress; Equip
層 = Layer; Stratum
操 = Operate; Handle; Maneuver
蔵 = Storehouse; Shelve
臓 = Internal organs; Viscera
存 = Exist; Preserve; Keep
尊 = Respect; Honor; Reverence
退 = Retreat; Withdraw; Decline; Retire
宅 = House; Home; Residence
担 = Shoulder; Carry; Bear
探 = Search; Explore; Probe
誕 = Birth
段 = Step; Stair; Grade
暖 = Warm
値 = Value; Price; Worth
宙 = Midair; Sky; Universe
忠 = Loyalty; Faithfulness
著 = Write; Author; Remarkable
庁 = Government office
頂 = Summit; Top; Receive
腸 = Intestines
潮 = Tide; Current
賃 = Fare; Rent; Wage
痛 = Pain; Ache
敵 = Enemy; Opponent
展 = Unfold; Exhibit; Expand
討 = Attack; Subjugate; Chastise
党 = Party; Faction
糖 = Sugar
届 = Reach; Deliver; Notify
難 = Difficult; Hard; Trouble
乳 = Milk; Breast
認 = Acknowledge; Recognize; Approve
納 = Settle; Pay; Store
脳 = Brain
派 = Faction; Group; Sect
拝 = Worship; Bow; Adore
背 = Back; Height; Turn away
肺 = Lung
俳 = Actor; Haiku Poet
班 = Group; Team; Squad
晩 = Evening; Night
否 = No; Negate; Refuse
批 = Criticize; Comment; Rebuke
秘 = Secret; Hidden
俵 = Straw bag
腹 = Belly; Abdomen
奮 = Excite; Strive; Exert; Rouse
並 = Line up; Alongside; Ordinary
陛 = Steps (of an imperial palace)
閉 = Close; Shut
片 = One-sided; Piece; Fragment
補 = Supplement; Compensate; Assist
暮 = Live; Get dark; End of the day
宝 = Treasure
訪 = Visit; Call on
亡 = Die; Lost; Perish; Escape
忘 = Forget
棒 = Stick; Rod; Pole
枚 = Sheet; Counter for flat objects
幕 = Curtain; Act; Tent
密 = Secret; Dense; Close
盟 = Alliance; Pact; Union
模 = Model; Pattern; Imitate
訳 = Translation; Reason; Explanation
郵 = Mail; Post
優 = Superior; Gentle; Actor
預 = Deposit; Entrust
幼 = Infant; Young; Childish
欲 = Desire; Want; Greed
翌 = Next (day/year)
乱 = Disorder; Chaos; Riot
卵 = Egg; Ovum
覧 = Look at; View
裏 = Back; Reverse side; Inside
律 = Law; Regulation; Rhythm
臨 = Face; Attend; Confront
朗 = Bright; Clear; Cheerful
論 = Argument; Theory; Discuss
