悪 = Bad; Evil
安 = Cheap; Safe; Peace
暗 = Dark; Dim
医 = Medical; Doctor
委 = Committee; Entrust
意 = Meaning; Intent
育 = Education; Grow Up
員 = Member; Staff
院 = Institution; Hospital
飲 = Drink; Swallow
運 = Carry; Luck; Drive
泳 = Swim
駅 = Station
央 = (Center)
横 = Horizontal; Side; Crossing
屋 = Shop; Roof
温 = Warm; Temperature
化 = Transform; (Chemistry)
荷 = Luggage; Cargo; Load
界 = World; Field
開 = Open
階 = Floor
寒 = Cold
感 = Feeling; Sense
漢 = Ancient China; Kanji; Man
館 = Hall; Mansion
岸 = Shore; Coast
起 = Wake Up; Happen
期 = Period; Time; Opportunity
客 = Customer; Guest
究 = Research
急 = Urgent
級 = Grade
宮 = Palace
球 = Ball; Globe
去 = Leaving; Previous
橋 = Bridge
業 = Business; Work; Karma
曲 = Song; Bending
局 = Bureau; Department; Office Lady
銀 = Silver
区 = Ward; Section; District
苦 = Bitter; Painful; Weak Point
具 = Ingredients; Tools
君 = You
係 = Person In Charge
軽 = Light (the opposite of heavy)
血 = Blood
決 = Decide; Determination
研 = Lab; Study; Training; Sharpen
県 = Prefecture
庫 = Repository; Vault; Warehouse
湖 = Lake
向 = Go Towards; Direction; Suitable
幸 = Happy; Lucky
港 = Port; Harbor
号 = Number; Issue
根 = Root
祭 = Festival; Enshrine
皿 = Dish; Plate
仕 = Serve; Service
死 = Death; Die
使 = Use; Messenger
始 = Begin
指 = Finger; Pointing
歯 = Teeth
詩 = Poem
次 = Next; (-th)
事 = Thing; Case; Matter
持 = Hold
式 = Formula; Style; Ceremony; Type
実 = Fruit; Truth; Reality; Nut
写 = Photo; Copy
者 = Person; Someone
主 = Main; Master; Lord
守 = Protect; Defend; Guard
取 = Take; Pick Up
酒 = Alcohol
受 = Receive
州 = State; Province; Sandbank
拾 = Pick Up
終 = Ending
習 = Learn; Habit
集 = Collection; Gather
住 = Reside; Living
重 = Heavy
宿 = Inn; Stay
所 = Place; Location
暑 = Heat; Hot; Humid
助 = Help; Assist; Rescue
昭 = Showa Era
消 = Erase; Disappear; Extinguish
商 = Business; Quotient
章 = Chapter
勝 = Victory; Win
乗 = Ride; -th Power
植 = Plant
申 = Stating; (Monkey)
身 = Body
神 = God; Diety
真 = True; Genuine
深 = Deep
進 = Move On; Progress; -base number
世 = World; Society; Generation
整 = Adjust
昔 = Long Ago; Olden Days
全 = All; Entirely
相 = (Mutual); (Phase); (Aspect)
送 = Send
想 = Thoughts; Idea; Imagination
息 = Breath
速 = Fast; Quick
族 = Group; Tribe
他 = Other; Others
打 = Hit; Strike
対 = Pair; Versus
待 = Wait
代 = Generation; Era; Substitution
第 = No.; -th
題 = Subject; Problem; Theme
炭 = Charcoal
短 = Short (of length)
談 = Story; Talk
着 = Arrival; Clothing
注 = Note; Annotate; Minding; Pour
柱 = Pillar
丁 = Block; Cho (Japanese unit); Even number
帳 = Account; Notebook
調 = Tone; Investigate; Tune
追 = Follow Up; Chase; Run After
定 = Constant; Preset; Decide
庭 = Garden; Yard
笛 = Whistle; Flute
鉄 = Iron
転 = Roll
都 = Capital
度 = Degree; Time; Occasion
投 = Throw
豆 = Beans
島 = Island
湯 = Hot Water
登 = Climb; Ascend; (Register)
等 = Etc.; Equal; Grade
動 = Move; Motion
童 = Child
農 = Agriculture
波 = Wave
配 = Distribute; Deliver
倍 = Doubled; Multiplied
箱 = Box
畑 = Field (of not rice)
発 = Departure; Beginning
反 = Anti-; Opposite
坂 = Slope; Hill
板 = Board; Plank
皮 = Leather; Skin; Bark
悲 = Sad
美 = Beauty
鼻 = Nose
筆 = Writing Brush
氷 = Ice
表 = Table; Surface; Reveal
秒 = Seconds
病 = Disease; Illness
品 = Goods; Product
負 = Negative; Minus; Lose; Bear
部 = Part; Department; Category; Club
服 = Clothes; Dosing
福 = Good Fortune
物 = Object; Thing; Stuff
平 = Flat; Broad
返 = Return
勉 = Exertion; Study
放 = Release
味 = Taste; Flavor
命 = Life; Command
面 = Face; Side; Surface
問 = Question; Asking
役 = Role; Position; Service; (Battle)
薬 = Drug; Medicine
由 = Reason; Cause
油 = Oil
有 = Possess; There Is
遊 = Play; Enjoy
予 = Forecast
羊 = Sheep
洋 = Western; Sea
葉 = Leaf
陽 = Sunlight; (Positive)
様 = Mr./Ms.; Manner; Way
落 = Fall; Drop
流 = Flow; Stream; Style; Manner; Method
旅 = Journey; Travel; Trip; Tour
両 = Both; (Old Japanese currency)
緑 = Green
礼 = Courtesy; Etiquette; Manners
列 = Column; Queue
練 = Training; Kneeding
路 = Road; Path
和 = Sum; Harmony; Japanese style
