悪 = よくないことや、よくないこころのことです。
安 = ねだんがやすいことや、あんしんできることです。
暗 = 明(あ)かりがなくてよく見(み)えないことです。
医 = 病気(びょうき)をなおす、お医者(いしゃ)さんのことです。
委 = 仕事(しごと)をまかせることや、たのむことです。
意 = やりたい気(き)もちや考(かんが)えのことです。
育 = 子(こ)どもやどうぶつをそだてることです。
員 = チームやクラスの仲間(なかま)の一人(ひとり)のことです。
院 = びょういんやがくいんなど、『～いん』とよばれるたてもののことです。
飲 = 水(みず)やジュースを口(くち)から取(と)りこむことです。
運 = 荷物(にもつ)をはこぶことや、車(くるま)を運転(うんてん)することです。
泳 = 手足(てあし)やひれをつかって、水面(すいめん)や水中(すいちゅう)を移動(いどう)することです。
駅 = 電車(でんしゃ)に乗(の)ったり降(お)りたりする場所(ばしょ)です。
央 = まんなかのところです。
横 = たてとはちがう向(む)きのことです。
屋 = やねのあるいえやおみせのことです。
温 = おんせんのお湯(ゆ)のようにあたたかいことです。
化 = 形(かたち)や姿(すがた)が変(か)わることです。
荷 = ものを背負(せお)うことや、荷物(にもつ)のことです。
界 = せかいや、きょうかいのようにくぎられたはんいのことです。
開 = ドアやまどをあけること、ひらくことです。
階 = たてものの一階(いっかい)や二階(にかい)などのことです。
寒 = 気温(きおん)が下(さ)がって体(からだ)が冷(つめ)たくなることです。
感 = うれしいやかなしいなど、こころでかんじることです。
漢 = 漢字(かんじ)の『かん』や、むかしの言い方でおとこの人のことです。
館 = 図書館(としょかん)や体育館(たいいくかん)などの大(おお)きなたてものです。
岸 = 川(かわ)や海(うみ)の端(はし)のところです。
起 = 朝(あさ)、ねむりからさめることです。
期 = 日時(にちじ)の範囲(はんい)のことです。
客 = 店(みせ)に来(く)る、おきゃくさんのことです。
究 = わからないことを深(ふか)く調(しら)べることです。
急 = 早(はや)くしよう、早(はや)く終(おわ)らせようとすることです。
級 = クラスや段階(だんかい)をあらわすことばです。
宮 = 神社(じんじゃ)や宮殿(きゅうでん)など、大(おお)きなたてものです。
球 = ボールのような丸(まる)いものです。
去 = 人(ひと)がいなくなることや、時間(じかん)がすぎさることです。
橋 = 川(かわ)や道(みち)の上(うえ)にかけてわたるものです。
業 = 仕事(しごと)やべんきょうのことです。
曲 = 歌(うた)やメロディーのこと、くねくねまがることです。
局 = 郵便局(ゆうびんきょく)のように仕事(しごと)をするばしょです。
銀 = 白(しろ)っぽく光(ひか)る、ぎんという金属(きんぞく)のことです。
区 = 街(まち)の中(なか)をわけた地域(ちいき)のことです。
苦 = 苦(にが)い味(あじ)やつらいことです。
具 = 料理(りょうり)の具材(ぐざい)や、道具(どうぐ)のことです。
君 = 友達(ともだち)や近(ちか)くの人(ひと)を呼(よ)ぶことばです。
係 = 仕事(しごと)をまかされた人(ひと)です。
軽 = 重(おも)くないことです。
血 = けがをしたときに体(からだ)から出(で)る、赤(あか)い液(えき)のことです。
決 = ルールやたいどをはっきりすることです。
研 = 何(なに)かのことをよく調(しら)べることです。
県 = 日本(にほん)の土地(とち)をわけたものの名前(なまえ)です。
庫 = ものをしまっておく大(おお)きな部屋(へや)です。
湖 = 陸地(りくち)で囲(かこ)まれ、くぼ地(ち)で水(みず)をたくわえたところです。
向 = 方向(ほうこう)を合(あ)わせること、合(あ)っていることです。
幸 = 友達(ともだち)と遊(あそ)ぶときのような、こころよい気もちです。
港 = 船(ふね)がとまるばしょです。
号 = 住所(じゅうしょ)の番号(ばんごう)や電話(でんわ)番号(ばんごう)などのことです。
根 = 木(き)のねっこのことです。
祭 = 毎年(まいねん)おこなわれる儀式(ぎしき)や楽(たの)しみごとです。
皿 = ごはんやおかずを乗(の)せる皿(さら)のことです。
仕 = 仕事(しごと)をすることです。
死 = いきものの命(いのち)がなくなることです。
使 = えんぴつや道具(どうぐ)などをつかうことです。
始 = 新(あたら)しく物事(ものごと)をおこなうことです。
指 = 手足(てあし)の先(さき)のわかれた部分(ぶぶん)です。
歯 = ごはんをかむときにつかう口(くち)の中(なか)のかたい部分(ぶぶん)です。
詩 = うたのように書(か)かれた文章(ぶんしょう)です。
次 = 後(あと)にすぐ続(つづ)くこと、続(つづ)くものです。
事 = 学校(がっこう)の行事(ぎょうじ)や出来事(できごと)のことです。
持 = 手(て)でものをつかんだままにすること、所有(しょゆう)することです。
式 = 入学式(にゅうがくしき)のように、きまったやりかたでおこなうことです。
実 = 本当(ほんとう)のことや、果物(くだもの)の実(み)のことです。
写 = すがた、形(かたち)をまねて表(あらわ)すことです。
者 = 学者(がくしゃ)のように、『～をする人』といういみでつかうことばです。
主 = 中心(ちゅうしん)になる人(ひと)や、代表的(だいひょうてきな)なもののことです。
守 = きずついたり、なくなったりしないように大切(たいせつ)にすることです。
取 = 手(て)に持(も)つこと、つかんで持(も)っていくことです。
酒 = 大人(おとな)がのむ、よっぱらう飲(の)みもののことです。
受 = さしだされたものを自分(じぶん)のものとしてもらうことです。
州 = 土砂(どしゃ)がたまって水面(すいめん)から出(で)ている部分(ぶぶん)です。
拾 = 落(お)ちているものを手(て)で取(と)りあげることです。
終 = ものごとや動作(どうさ)が最後(さいご)になり、続(つづ)かなくなることです。
習 = 知識(ちしき)や技術(ぎじゅつ)を他人(たにん)から教(おそ)わることです。
集 = 散(ち)らばっているものをある場所(ばしょ)にまとめることです。
住 = 家(いえ)で生活(せいかつ)をおくることです。
重 = 地球(ちきゅう)から引(ひ)っぱられる力(ちから)が強(つよ)いものです。
宿 = 旅館(りょかん)やホテルなど、宿泊(しゅくはく)する場所(ばしょ)です。
所 = ある地点(ちてん)、場所(ばしょ)のことです。
暑 = 夏(なつ)のあつさのことです。
助 = 手伝(てつだ)いをすること、危険(きけん)や苦痛(くつう)をのがれさせることです。
昭 = 明(あか)るくてはっきりしている、といういみの漢字(かんじ)です。
消 = なくすること、見(み)えなくなることです。
商 = 店(みせ)などで売(う)り買(か)いすることです。
章 = ひとまとまりの文(ぶん)や楽曲(がっきょく)です。
勝 = 争(あらそ)って相手(あいて)を負(ま)かすことです。
乗 = 自転車(じてんしゃ)やバスなどの上(うえ)や中(なか)に上(あ)がることです。
植 = 草木(くさき)を土(つち)に根(ね)をのばすように少(すこ)し埋(う)めることです。
申 = 相手(あいて)を敬(うやま)って何(なに)かを言(い)い伝(つた)えることです。
身 = 体(からだ)や中身(なかみ)のことです。
神 = 人間(にんげん)を超(こ)えた、偉(えら)い存在(そんざい)のことです。
真 = うそではない、本当(ほんとう)のことです。
深 = 海(うみ)のように底(そこ)が下(した)の方(ほう)にあることです。
進 = 前(まえ)の方に移動(いどう)することです。
世 = この世界(せかい)、地球(ちきゅう)のことです。
整 = 乱(みだ)れを直(なお)し、きちんとした状態(じょうたい)にすることです。
昔 = むかしばなしのむかし、今(いま)よりもずっと前(まえ)のことです。
全 = ぜんぶのことです。
相 = すがた、形、外見(がいけん)のことです。
送 = 手紙(てがみ)やメール、荷物(にもつ)などを運(はこ)んでもらうことです。
想 = 考(かんが)えや、思(おも)いのことです。
息 = 口(くち)から、ふっと出(で)る空気(くうき)のことです。
速 = スピードが高(たか)いことです。
族 = 家族(かぞく)のような集(あつ)まりのことです。
他 = 家族(かぞく)ではない人(ひと)や別(べつ)のもののことです。
打 = あるものを他(ほか)のものに、いきおいよく当(あ)てることです。
対 = 相手(あいて)とむかいあうこと、２つのもののことです。
待 = 人(ひと)やものが来(く)るのを望(のぞ)みながら時(とき)を過(す)ごすことです。
代 = 何(なに)かのかわりや、時(とき)の流(なが)れのことです。
第 = 第一(だいいち)、第二(だいに)のように順番(じゅんばん)を表(あらわ)すことばです。
題 = 課題(かだい)やタイトルのことです。
炭 = 火(ひ)が燃(も)えた後(あと)にできる黒(くろ)くて燃(も)えやすいものです。
短 = 長(なが)さや時間(じかん)が小(ちい)さいことです。
談 = だれかとしゃべることです。
着 = 服(ふく)を身(み)につけることや、場所(ばしょ)に来(く)ることです。
注 = 注意(ちゅうい)したり、コップに水(みず)を注(そそ)ぐことです。
柱 = 家(いえ)をささえる太(ふと)いもののことです。
丁 = ちょうどいいことや、町(まち)の番地(ばんち)を表(あらわ)すことばです。
帳 = ノートや手帳(てちょう)などのことです。
調 = 何(なに)かの目的(もくてき)で、見(み)たり、たずねたり、本(ほん)を読(よ)むことです。
追 = 何(なに)かを加(くわ)えること、にげる人(ひと)をおいかけることです。
定 = 予定(よてい)のように、決(き)まること、決(き)まっていることです。
庭 = 土地(とち)に草木(くさき)や池(いえ)などをそえる空間(くうかん)です。
笛 = 息(いき)を強(つよ)く吹(ふ)きいれると音(おと)が鳴(な)るものです。
鉄 = 自動車(じどうしゃ)やレールに使(つか)われる、かたい金属(きんぞく)です。
転 = 自転車(じてんしゃ)のタイヤがころがるように、動(うご)くことです。
都 = 東京(とうきょう)のような大(おお)きな街(まち)、みやこのことです。
度 = 温度(おんど)や回数(かいすう)を表(あらわ)すことばです。
投 = ボールなどを、いきおいよくとばすことです。
豆 = 大豆(だいず)や小豆(あずき)などの小(ちい)さなつぶです。
島 = 水(みず)に囲(かこ)まれた陸地(りくち)のことです。
湯 = お風呂(ふろ)のような熱(あつ)くなった水(みず)のことです。
登 = 山(やま)などの高(たか)いばしょに上(あ)がることです。
等 = 『みかんやりんごなど』の『など』のこと、２つが同(おな)じことです。
動 = 位置(いち)を変(か)えることです。
童 = 児童(じどう)や童話(どうわ)のように、子(こ)どものことをいうことばです。
農 = 野菜(やさい)や米(こめ)などをつくる仕事(しごと)です。
波 = 海(うみ)などのゆれる水(みず)のことです。
配 = 手紙(てがみ)やプリントなどを、一人(ひとり)一(ひと)つずつわたすことです。
倍 = 二倍(にばい)、三倍(さんばい)のようにふえることです。
箱 = おもちゃなどをまとめて入(い)れる入(い)れ物(もの)のことです。
畑 = 野菜(やさい)や果物(くだもの)を育(そだ)てる土地(とち)です。
発 = お出(で)かけすること、ものを送(おく)り出(だ)すことです。
反 = 何(なに)かにさからうことです。
坂 = 山(やま)や町(まち)のかたむいた道(みち)、坂道(さかみち)のことです。
板 = うすく平(ひら)たいものです。
皮 = ミカンのかわや、皮(ひ)ふのことです。
悲 = 泣(な)きたくなるような気分(きぶん)のことです。
美 = 花(はな)や景色(けしき)がすばらしいことです。
鼻 = 臭(にお)いをかぐ、顔(かお)の真(ま)ん中(なか)の器官(きかん)のことです。
筆 = えんぴつやふでなど、かく道具(どうぐ)です。
氷 = 水(みず)が冷(つめ)たくなってこおったものです。
表 = ノートの表(おもて)や、文字(もじ)や絵(え)に表(あらわ)すことです。
秒 = 一秒(いちびょう)、二秒(にびょう)のようにとても短(みじか)い時間(じかん)です。
病 = 風邪(かぜ)や病気(びょうき)のことです。
品 = お店(みせ)で売(う)っている、いろいろなもののことです。
負 = 勝負事(しょうぶごと)でやぶれることです。
部 = サッカー部(ぶ)などのクラブや部分(ぶぶん)のことです。
服 = シャツやズボンなど、着(き)るものです。
福 = 幸(しあわ)せや良(よ)いことのことです。
物 = ものやどうぶつ、しょくぶつなどのことです。
平 = でこぼこのないことです。
返 = 借(か)りたものをもちぬしにもどすことです。
勉 = がんばること、無理(むり)をすることです。
放 = ボールなどをなげたり、てばなすことです。
味 = 舌(した)で感(かん)じる、食(た)べもののあじのことです。
命 = いきものが生(い)きていることです。
面 = 顔(かお)やカベ、平(たい)らなところのことです。
問 = 質問(しつもん)や問題(もんだい)のことです。
役 = わりあてられた仕事(しごと)のしゅるいを表(あらわ)す言葉(ことば)です。
薬 = 病気(びょうき)を直(なお)すクスリのことです。
由 = 理由(りゆう)や訳(わけ)のことです。
油 = 料理(りょうり)などにつかう、あぶらのことです。
有 = もっていることや、あることです。
遊 = 仕事(しごと)や勉強(べんきょう)をしないこと、楽(たの)しく過(す)ごすこととです。
予 = まえもってきめておくことです。
羊 = どうぶつのヒツジのことです。
洋 = 太平洋(たいへいよう)のような、広(ひろ)い海(うみ)のことです。
葉 = きやくさの緑(みどり)のはっぱのことです。
陽 = おひさまの光(ひかり)のことです。
様 = 人(ひと)を呼(よ)ぶときのことばや、様子(ようす)のことです。
落 = 高(たか)いところから低(ひく)いところに移動(いどう)することです。
流 = 川(かわ)の水(みず)が流(なが)れることです。
旅 = 遠(とお)いところに出(で)かけることです。
両 = 両手(りょうて)、両足(りょうあし)のように、２つのもののことです。
緑 = みずみずしい草(くさ)の色(いろ)のことです。
礼 = おじぎをしたり、ありがとうという気持(きも)ちをあらわすことです。
列 = ならぶぎょうれつのことです。
練 = スポーツや楽器(がっき)を練習(れんしゅう)することです。
路 = 道(みち)や道路(どうろ)のことです。
和 = 仲良(なかよ)くすることや、日本(にほん)の風景(ふうけい)のことです。
